;;;;;;;;;;;;;;;;;;;;;;;;
;;;;;;;;;;;;;;;;;;;;;;;;
;;;;;;;;t1;;;;;;;;;;;;;;
;;;;t1;;t1;;t1;;;;;;;;;;
;;t1;;b1;;m1;;b1;;t1;;;;
t1;;t1;;t1;;t1;;t1;;t1;;
;;;;;;;;;;;;;;;;;;;;;;;;
;;;;;;;;;;;;;;;;;;;;;;;;
