;;;;;;;;;;;;;;;;;;;;;;;;
;;;;;;;;t2;;;;;;;;;;;;;;
;;;;t1;;;;;;;;t1;;;;;;;;
t3;;;;t3;;m3;;t3;;;;t3;;
;;;;b1;;;;;;;;b1;;;;;;;;
;;;;;;;;b2;;;;;;;;;;;;;;
;;;;;;;;;;;;;;;;;;;;;;;;
;;;;;;;;;;;;;;;;;;;;;;;;
