t1;;;;m1;;;;t1;;;;b1;;;;
b1;;;;;;;;t1;;;;;;;;m1;;
m1;;;;;;;;b1;;;;;;;;t1;;
t1;;;;;;;;m1;;;;;;;;b1;;
b1;;;;;;;;t1;;;;;;;;m1;;
m1;;;;;;;;b1;;;;;;;;t1;;
t1;;;;;;;;m1;;;;;;;;b1;;
;;;;;;;;;;;;;;;;;;;;;;;;
