;;;;;;;;;;;;;;;;;;;;;;;;
;;;;t1;;t1;;t1;;t1;;;;;;
;;t2;;b1;;m1;;b1;;t2;;;;
t3;;;;;;;;;;;;;;;;;;t3;;
;;m2;;;;;;;;;;;;;;m2;;;;
;;;;;;;;;;;;;;;;;;;;;;;;
;;;;;;;;;;;;;;;;;;;;;;;;
;;;;;;;;;;;;;;;;;;;;;;;;
