;;;;;;;;;;;;;;;;;;;;;;;;
;;;;;;;;b1;t1;b1;;;;;;;;
;;;;b1;;;;;;;;;;b1;;;;;;
;;b1;;;t2;;;;t2;;;b1;;;;
;;m1;;;t3;;;;t3;;;m1;;;;
;;;;m1;;;;;;;;;;m1;;;;;;
;;;;;;;;m1;t1;m1;;;;;;;;
;;;;;;;;;;;;;;;;;;;;;;;;
