t1;;;;;;;;;;;;;;b1;;;;;;
b1;;;;t2;;;;;;;;m1;;;;;;
m1;;;;m2;;;;t2;;;;;;;;;;
t2;;;;t2;;;;m2;;;;;;;;;;
b2;;;;b2;;;;t2;;;;;;;;;;
m2;;;;m2;;;;b2;;;;;;;;;;
t2;;;;;;;;;;b2;;;;;;;;;;
b2;;;;;;;;;;t1;;;;;;;;;;
