t1;;b1;;m1;;t2;;b2;;m2;;
b1;;t1;;b1;;t2;;b2;;t2;;
m1;;b1;;m1;;b2;;t2;;m2;;
t1;;t1;;b1;;t2;;b2;;t2;;
b1;;m1;;b1;;b2;;m2;;b2;;
m1;;t1;;m1;;t2;;b2;;m2;;
t1;;b1;;t1;;t2;;b2;;t2;;
;;;;;;;;;;;;;;;;;;;;;;;;
