;;;;;;;;;;;;;;;;;;;;;;;;
;;;;;;;;t1;;;;;;;;;;;;;;
;;;;t2;;b1;;m1;;;;;;;;;;
t3;t3;t3;t3;t3;t3;t3;;;;
;;;;m2;;b2;;t2;;;;;;;;;;
;;;;;;;;t2;;;;;;;;;;;;;;
;;;;;;;;;;;;;;;;;;;;;;;;
;;;;;;;;;;;;;;;;;;;;;;;;
