t1;;m1;;b1;;t2;;m2;;b2;;
b1;;t1;;m1;;b2;;t2;;m2;;
m1;;b1;;t1;;m2;;b2;;t2;;
t1;;m1;;b1;;t2;;m2;;b2;;
b1;;t1;;m1;;b2;;t2;;m2;;
m1;;b1;;t1;;m2;;b2;;t2;;
t1;;m1;;b1;;t2;;m2;;b2;;
;;;;;;;;;;;;;;;;;;;;;;;;
