t1;t2;t3;b1;b2;b3;m1;m2;m3;
t2;t3;b1;b2;b3;m1;m2;m3;t1;
t3;b1;b2;b3;m1;m2;m3;t1;t2;
b1;b2;b3;m1;m2;m3;t1;t2;t3;
b2;b3;m1;m2;m3;t1;t2;t3;b1;
b3;m1;m2;m3;t1;t2;t3;b1;b2;
m1;m2;m3;t1;t2;t3;b1;b2;b3;
m2;m3;t1;t2;t3;b1;b2;b3;m1;
m3;t1;t2;t3;b1;b2;b3;m1;m2;
